{
  "id": 0,
  "width": 15,
  "height": 11,
  "spawn_points": [[0,0], [14,0], [0,10], [14,10]],
  "target": [7,5],
  "data": [
     0, 1, 0, 1, 0, 0, 0, 1, 0, 0, 0, 1, 0, 1, 0,
     0, 0, 0, 1, 0, 1, 1, 1, 1, 1, 0, 1, 0, 0, 0,
     1, 1, 0, 1, 0, 1, 0, 1, 0, 1, 0, 1, 0, 1, 1,
     0, 0, 0, 1, 0, 0, 0, 1, 0, 0, 0, 1, 0, 0, 0,
     0, 1, 1, 1, 0, 1, 0, 1, 0, 1, 0, 1, 1, 1, 0,
     0, 0, 0, 0, 0, 1, 0, 0, 0, 1, 0, 0, 0, 0, 0,
     0, 1, 1, 1, 0, 1, 0, 1, 0, 1, 0, 1, 1, 1, 0,
     0, 0, 0, 1, 0, 0, 0, 1, 0, 0, 0, 1, 0, 0, 0,
     1, 1, 0, 1, 0, 1, 0, 1, 0, 1, 0, 1, 0, 1, 1,
     0, 0, 0, 1, 0, 1, 1, 1, 1, 1, 0, 1, 0, 0, 0,
     0, 1, 0, 1, 0, 0, 0, 1, 0, 0, 0, 1, 0, 1, 0
  ]
}
